#####################
#S....#.............#
#####.#.#############
#.....#.............#
#.#####.###########.#
#.#.....#.........#.#
#.#.#####.#######.#.#
#.#.#.....#.....#.#.#
#.#.#.#####.###.#.#.#
#...#.......#.#.#.#.#
#############.#.#.#.#
#.............#.#.#.#
#.#############.#.#.#
#.#.............#.#.#
#.#.#############.#.#
#.#...............#.#
#.#################.#
#.................#E#
#####################