###########
#S#.....#.#
#.#.###.#.#
#.#...#...#
#.###.###.#
#.....#...#
###.#.#.###
#...#.#...#
#.###.###.#
#.....#..E#
###########